51 [] [] [] [] -- -- -- 81 [] [] [] [] [] [] []
-- -- -- -- -- -- -- -- -- -- -- -- -- -- -- --
-- -- -- -- -- -- -- -- -- -- -- -- -- -- -- --
-- -- -- -- -- 32 [] [] -- -- -- -- -- -- -- --
-- -- ww -- -- [] [] [] 11 -- -- -- -- -- -- --
-- -- -- -- -- -- 22 [] -- -- -- -- -- -- -- --
-- -- -- -- -- -- [] [] -- -- -- -- dd dd -- --
-- -- -- -- -- -- 25 [] -- -- -- -- -- -- -- --
-- -- -- -- -- -- [] [] -- -- -- -- -- -- -- --
-- -- -- -- -- -- [] [] -- -- -- dd dd -- -- --
-- -- -- -- -- -- [] [] -- -- -- -- -- -- -- --
-- -- -- -- -- -- [] [] -- -- -- -- -- -- dd dd
-- mm -- -- -- -- -- -- -- -- -- -- -- -- -- --
43 [] [] [] -- -- -- -- -- -- -- -- dd dd -- --
[] [] [] [] -- -- -- -- dd dd -- -- -- -- -- --
[] [] [] [] dd -- -- -- -- -- -- -- -- -- -- --

ul -- -- -- -- -- -- -- ur -- -- -- -- -- -- --
-- -- -- -- -- -- -- -- -- -- -- -- -- -- -- --
-- -- -- -- -- -- -- -- -- -- -- -- -- -- -- --
-- -- -- -- -- .. -- -- -- -- -- -- -- -- -- --
-- -- -- -- -- -- -- -- .. -- -- -- -- -- -- --
-- -- -- -- -- -- u. -- -- -- -- -- -- -- -- --
-- -- -- -- -- -- -- -- -- -- -- -- -- -- -- --
-- -- -- -- -- -- .. -- -- -- -- -- -- -- -- --
-- -- -- -- -- -- -- -- -- -- -- -- -- -- -- --
-- -- -- -- -- -- -- -- -- -- -- -- -- -- -- --
-- -- -- -- -- -- -- -- -- -- -- -- -- -- -- --
-- -- -- -- -- -- -- -- -- -- -- -- -- -- -- --
-- -- -- -- -- -- -- -- -- -- -- -- -- -- -- --
ld -- -- -- -- -- -- -- -- -- -- -- -- -- -- --
-- -- -- -- -- -- -- -- -- -- -- -- -- -- -- --
-- -- -- -- -- -- -- -- -- -- -- -- -- -- -- --